6 8 8 8 8 8 8 8 8 8 8 8 8 22 8 8 8 8 8 8 8 8 22 8 8 8 8 8 8 8 8 8 8 8 8 8 8 8 8 8 8 8 8 8 8 8 8 8 8 8 8 8 8 8 8 8 22 8 8 8 8 8 8 8 8 8 8 8 8 8 8 8 8 8 8 8 8 8 8 7
11 0 0 0 0 0 0 0 0 0 0 0 0 0 0 0 0 0 0 0 0 0 11 0 0 0 0 0 0 0 0 0 0 0 0 0 0 0 0 0 0 0 0 0 0 0 0 0 0 0 0 0 0 0 0 0 11 0 0 0 0 0 0 0 0 0 0 0 0 0 0 0 0 0 0 0 0 0 0 5
11 0 0 9 8 8 8 8 7 0 0 0 0 1 0 7 0 0 0 0 0 0 15 0 0 0 0 0 0 0 6 7 0 0 0 0 0 0 0 0 0 0 0 0 0 0 0 0 0 0 0 0 0 0 0 0 11 0 0 0 0 0 0 0 0 0 0 0 0 0 0 0 0 0 0 0 0 0 0 5
11 0 0 0 0 0 0 0 5 0 0 0 0 0 0 5 0 0 0 0 0 0 0 0 0 0 0 0 0 0 11 5 0 0 0 0 0 0 0 0 6 7 0 0 0 0 0 0 0 0 0 0 0 0 0 0 15 0 0 0 0 0 0 0 0 0 0 0 0 0 0 0 0 0 0 0 0 0 0 5
11 0 0 18 0 0 0 0 19 8 8 8 8 8 8 8 8 8 8 8 8 8 8 8 8 20 0 0 0 0 11 5 0 0 0 0 0 0 0 0 11 5 0 0 0 0 0 0 0 0 0 0 0 0 0 0 0 0 0 0 0 0 0 0 0 0 0 0 0 0 0 0 0 0 0 0 0 0 0 5
11 0 0 5 0 0 0 0 0 0 0 0 0 0 0 0 0 0 0 0 0 0 0 0 0 11 0 0 0 0 1 2 0 0 0 0 0 0 0 0 11 5 0 0 0 0 0 0 0 0 0 0 0 0 0 0 0 0 0 0 0 0 0 0 0 0 0 0 0 0 0 0 0 0 0 0 0 0 0 5
13 0 9 21 8 8 8 8 8 8 7 0 0 0 0 0 0 0 0 0 0 0 0 0 0 11 0 0 0 0 0 0 0 23 8 8 8 8 8 8 8 8 8 8 8 8 8 8 8 8 8 8 8 8 8 8 8 8 8 8 7 0 0 0 0 0 0 0 0 0 0 0 0 0 0 0 0 0 0 5
11 0 23 2 0 0 0 0 0 0 5 0 0 0 0 0 0 0 0 0 0 0 0 0 0 1 8 8 8 8 8 8 8 2 0 0 0 0 0 0 0 0 0 0 0 0 0 0 0 0 0 0 0 0 0 0 0 0 0 0 5 0 0 0 0 0 0 0 0 0 0 0 0 0 0 23 8 8 8 21
11 0 5 0 0 0 0 0 0 0 5 0 0 0 0 0 0 0 0 0 0 0 0 0 0 0 0 0 0 0 0 0 0 0 0 0 0 0 0 0 0 0 0 0 0 0 0 0 0 0 0 0 0 0 0 0 0 0 0 0 5 0 0 0 0 0 0 0 0 0 0 0 0 0 0 5 0 0 0 5
11 0 5 0 0 0 0 0 0 0 5 0 0 0 0 0 0 0 0 0 0 0 0 0 0 0 0 0 0 0 0 0 0 0 0 0 0 0 0 0 0 0 0 0 0 0 0 0 0 0 0 0 0 0 0 0 0 0 0 0 19 8 8 8 8 22 8 8 8 8 8 8 8 8 8 2 0 0 0 5
13 8 2 0 0 0 0 0 0 0 19 8 8 8 8 8 8 8 8 8 8 8 8 8 8 8 8 8 8 8 10 0 0 0 0 9 8 8 8 8 8 8 8 7 0 0 0 0 0 6 8 8 8 8 8 8 7 0 0 0 0 0 0 0 0 11 0 0 0 0 0 0 0 0 0 0 0 0 0 5
11 0 0 0 0 0 0 0 0 0 0 0 0 0 0 0 0 0 0 0 0 0 0 0 0 0 0 0 0 0 0 0 0 0 0 0 0 0 0 0 0 0 0 5 0 0 0 0 0 11 0 0 0 0 0 0 5 0 0 0 0 0 0 0 0 11 0 0 0 0 0 0 0 0 0 0 0 0 0 5
11 0 0 0 0 0 0 0 0 0 0 0 0 0 0 0 23 8 8 8 7 0 0 0 0 0 0 0 0 0 0 0 0 0 0 0 0 0 0 0 6 7 0 5 0 0 0 0 0 11 0 0 0 0 0 0 19 8 8 8 7 0 0 0 0 11 0 0 0 23 8 8 10 0 0 0 0 0 0 5
13 8 8 8 8 10 0 0 0 0 0 0 0 0 0 0 5 0 0 0 5 0 0 0 0 0 0 0 0 0 23 8 8 7 0 0 0 0 0 0 1 2 0 5 0 0 0 0 0 11 0 0 0 0 0 0 0 0 0 0 5 0 0 0 0 15 0 0 0 5 0 0 0 0 0 6 7 0 0 5
11 0 0 0 0 0 0 0 0 0 0 0 0 0 0 0 19 24 0 0 19 8 8 8 7 0 0 0 0 0 5 0 0 5 0 0 0 0 0 0 0 0 0 5 0 0 0 0 0 11 0 0 0 0 0 0 0 0 0 0 5 0 0 0 0 0 0 0 0 5 0 0 0 0 0 11 5 0 0 5
11 0 0 0 0 0 0 0 0 0 0 0 0 0 0 0 0 5 0 0 0 0 0 0 5 0 0 0 0 0 5 0 0 19 8 8 7 0 0 0 0 0 0 5 0 0 0 0 0 11 0 0 23 8 7 0 0 0 0 0 5 0 0 0 0 0 0 0 0 5 0 0 0 0 0 11 5 0 0 5
11 0 0 0 23 8 8 8 8 8 8 20 0 0 0 0 0 19 8 8 8 8 24 0 5 0 0 0 0 0 5 0 0 0 0 0 5 0 0 0 0 0 0 5 0 0 0 0 0 11 0 0 5 0 5 0 0 0 0 0 19 8 8 8 8 8 8 8 8 2 0 0 0 0 0 11 5 0 0 5
11 0 0 0 5 0 0 0 0 0 0 11 0 0 0 0 0 0 0 0 0 0 5 0 5 0 0 0 0 0 19 8 8 8 24 0 5 0 0 0 0 0 0 5 0 0 0 0 0 15 0 0 5 0 19 8 8 8 7 0 0 0 0 0 0 0 0 0 0 0 0 0 0 0 0 11 5 0 0 5
11 0 0 0 5 0 0 0 0 0 0 11 0 0 0 0 0 0 0 0 0 0 5 0 5 0 0 0 0 0 0 0 0 0 5 0 5 0 0 0 0 0 0 16 0 0 0 0 0 0 0 0 19 24 0 0 0 0 5 0 0 0 0 0 0 0 0 0 0 0 0 0 0 0 0 11 5 0 0 5
13 10 0 9 2 0 0 0 0 0 0 1 8 8 8 8 8 8 20 0 0 0 19 8 2 0 0 0 0 0 0 0 0 0 19 8 2 0 0 0 0 0 0 0 0 0 0 0 0 0 0 0 0 5 0 0 0 0 5 0 0 0 0 0 0 0 0 0 0 0 0 0 0 0 0 1 2 0 0 5
11 0 0 0 0 0 0 0 0 0 0 0 0 0 0 0 0 0 11 0 0 0 0 0 0 0 0 0 0 0 0 0 0 0 0 0 0 0 0 0 0 0 0 0 0 0 0 0 0 0 0 0 0 19 8 8 8 8 2 0 0 0 0 0 0 0 0 0 0 0 0 0 0 0 0 0 0 0 0 5
11 0 0 0 0 0 0 0 0 0 0 0 0 0 0 0 0 0 11 0 0 0 0 0 0 0 0 0 0 0 0 0 0 0 0 0 0 0 0 0 0 0 0 0 0 0 0 0 0 0 0 0 0 0 0 0 0 0 0 0 0 0 0 0 0 0 0 0 0 0 0 0 0 0 0 0 0 0 0 5
13 8 8 8 8 8 8 8 7 0 0 0 0 0 0 0 0 0 1 8 8 8 8 8 8 8 8 8 8 8 8 8 8 8 8 8 8 8 8 8 10 0 0 0 0 0 0 0 0 0 0 0 9 8 8 8 8 8 8 8 8 8 8 8 8 8 8 10 0 0 0 9 8 8 8 8 8 8 8 21
11 0 0 0 0 0 0 0 5 0 0 0 0 0 6 7 0 0 0 0 0 0 0 0 0 0 0 0 0 0 0 0 0 0 0 0 0 0 0 0 0 0 0 0 0 0 0 0 0 0 0 0 0 0 0 0 0 0 0 0 0 0 0 0 0 0 0 0 0 0 0 0 0 0 0 0 0 0 0 5
11 0 0 0 0 0 0 0 5 0 0 0 0 0 11 5 0 0 0 0 0 0 0 0 0 0 0 0 0 0 0 0 0 0 0 0 0 0 0 0 0 0 0 0 0 0 0 0 0 0 0 0 0 0 0 0 0 0 0 0 0 0 0 0 0 0 0 0 0 0 0 0 0 0 0 0 0 0 0 5
11 0 0 0 0 0 0 0 16 0 0 0 0 0 11 5 0 0 0 0 0 0 0 0 0 0 0 0 0 0 0 0 0 0 0 0 0 0 0 0 0 0 0 0 0 0 0 0 0 0 0 0 0 0 0 0 0 0 0 0 0 0 0 0 0 0 0 0 0 0 0 0 0 0 0 0 0 0 0 5
11 0 0 0 0 0 0 0 0 0 0 0 0 0 11 5 0 0 23 8 8 8 8 10 0 0 0 0 9 8 8 8 8 8 8 8 8 8 22 8 8 8 10 0 0 0 0 0 0 0 0 9 8 8 8 8 8 8 8 8 10 0 0 0 0 0 0 0 0 0 23 8 8 7 0 0 0 0 0 5
13 8 10 0 0 0 0 0 0 0 6 7 0 0 1 2 0 0 5 0 0 0 0 0 0 0 0 0 0 0 0 0 0 0 0 0 0 0 11 0 0 0 0 0 0 0 0 0 0 0 0 0 0 0 0 0 0 0 0 0 0 0 0 0 0 9 8 8 8 8 2 0 0 19 8 8 7 0 0 5
11 0 0 0 0 17 0 0 0 0 1 2 0 0 0 0 0 0 5 0 0 0 0 0 0 0 0 0 0 0 0 0 0 0 0 0 0 0 11 0 0 0 0 0 0 0 0 0 0 0 0 0 0 0 0 0 0 0 0 0 0 0 0 0 0 0 0 0 0 0 0 0 0 0 0 0 19 8 8 21
11 0 0 0 0 11 0 0 0 0 0 0 0 0 0 0 0 0 5 0 0 0 0 0 0 0 0 0 0 0 0 0 0 0 0 0 0 0 15 0 0 0 0 0 0 0 0 0 0 0 0 0 0 6 8 8 8 8 8 8 7 0 0 0 0 0 0 0 0 0 0 0 0 0 0 0 0 0 0 5
11 0 0 0 0 1 8 20 0 0 0 0 0 18 0 0 0 0 5 0 0 0 0 6 8 8 8 8 8 7 0 0 0 0 0 0 0 0 0 0 0 0 0 18 0 0 0 0 0 0 0 0 0 1 8 8 8 8 8 8 2 0 0 0 23 8 8 8 8 8 8 7 0 0 0 0 0 0 0 5
11 0 0 0 0 0 0 11 0 0 0 0 0 5 0 0 0 0 5 0 0 0 0 11 0 0 0 0 0 5 0 0 0 0 0 0 0 0 0 0 0 0 0 5 0 0 0 0 0 17 0 0 0 0 0 0 0 0 0 0 0 0 0 0 19 8 8 7 0 0 0 5 0 0 23 8 8 8 8 21
11 0 0 0 0 0 0 11 0 0 0 0 0 5 0 0 0 0 5 0 0 0 0 11 0 0 0 0 0 5 0 0 0 0 0 18 0 0 6 7 0 0 0 5 0 0 0 0 0 11 0 0 0 0 0 0 0 0 0 0 0 0 0 0 0 0 0 5 0 23 8 2 0 0 5 0 0 0 0 5
11 0 0 0 0 0 0 1 8 22 8 8 22 21 8 8 8 8 2 0 0 0 0 1 8 8 8 8 8 2 0 0 0 0 0 5 0 0 1 2 0 0 0 5 0 0 0 0 0 11 0 0 0 6 8 8 7 0 0 0 0 0 0 0 0 0 0 19 8 2 0 0 0 0 5 0 0 0 0 5
11 0 0 0 0 0 0 0 0 11 0 0 1 2 0 0 0 0 0 0 0 0 0 0 0 0 0 0 0 0 0 0 0 0 0 5 0 0 0 0 0 0 0 5 0 0 0 0 0 11 0 0 0 1 8 8 2 0 0 0 23 8 8 8 7 0 0 0 0 0 0 0 0 0 16 0 0 0 0 5
11 0 0 0 0 0 0 0 0 11 0 0 0 0 0 0 0 0 0 0 0 0 0 0 0 0 0 0 0 0 0 0 0 0 0 5 0 0 0 0 0 0 0 5 0 0 0 0 0 11 0 0 0 0 0 0 0 0 0 0 5 0 0 0 5 0 0 0 0 0 0 0 0 0 0 0 0 0 0 5
11 0 0 0 0 0 0 0 0 15 0 0 0 0 0 4 0 0 0 0 0 23 8 8 8 8 8 8 8 8 8 8 8 8 8 21 8 8 8 8 8 8 8 2 0 0 0 0 0 1 8 8 8 8 8 8 8 8 8 8 2 0 0 0 5 0 0 0 0 4 0 0 0 0 0 0 0 18 0 5
13 8 10 0 0 7 0 0 0 0 0 0 0 0 0 14 0 0 0 0 0 5 0 0 0 0 0 0 0 0 0 0 0 0 0 5 0 0 0 0 0 0 0 0 0 0 0 0 0 0 0 0 0 0 0 0 0 0 0 0 0 0 0 0 5 0 0 0 0 14 0 0 0 0 18 0 0 19 8 21
11 0 0 0 0 5 0 0 0 0 0 0 0 0 0 14 0 0 0 0 0 5 0 0 0 0 0 0 0 0 0 0 0 0 0 5 0 0 0 0 0 0 0 0 0 0 0 0 0 0 0 0 0 0 0 0 0 0 0 0 0 0 0 0 5 0 0 0 0 14 0 0 0 0 5 0 0 0 0 5
11 0 0 0 0 19 8 8 8 8 8 8 8 8 8 8 8 8 8 8 8 2 0 0 6 7 0 0 0 0 0 0 0 0 0 5 0 0 0 0 0 0 0 0 0 0 0 0 0 0 0 0 0 0 0 6 7 0 0 0 0 0 0 0 19 8 8 8 8 8 8 8 8 8 2 0 0 0 0 5
11 0 0 0 0 0 0 0 0 0 0 0 0 0 0 0 0 0 0 0 0 0 0 0 11 5 0 0 0 0 0 0 0 0 0 16 0 0 0 0 0 0 0 0 0 0 0 0 0 0 0 0 0 0 0 11 5 0 0 0 0 0 0 0 0 0 0 0 0 0 0 0 0 0 0 0 6 7 0 5
11 0 0 0 0 0 0 0 0 0 0 0 0 0 0 0 0 0 0 0 0 0 0 0 11 5 0 0 0 0 0 0 0 0 0 0 0 0 0 0 0 0 0 0 0 0 0 0 0 0 0 0 0 0 0 11 19 8 7 0 0 0 0 0 0 6 7 0 0 0 0 0 0 0 0 0 1 2 0 5
11 0 0 0 0 0 0 0 0 0 0 0 0 0 0 0 0 0 0 23 8 7 0 0 11 5 0 0 0 0 0 0 0 0 0 0 0 0 0 0 0 0 0 6 8 8 8 8 8 10 0 0 0 0 0 1 8 8 2 0 0 0 0 0 0 1 2 0 0 0 6 7 0 0 0 0 0 0 0 5
13 8 8 8 8 8 8 8 8 8 7 0 0 0 0 0 0 0 0 19 24 5 0 0 1 2 0 0 0 0 0 0 0 0 0 0 0 0 0 0 0 0 0 11 0 0 0 0 0 0 0 0 0 0 0 0 0 0 0 0 0 0 0 0 0 0 0 0 0 0 11 5 0 0 0 0 0 0 0 5
11 0 0 0 0 0 0 0 0 0 5 0 0 0 0 0 17 0 0 0 5 5 0 0 0 0 0 0 0 6 8 8 8 8 7 0 0 0 0 0 0 0 0 11 0 0 0 0 0 0 0 0 0 0 0 0 0 0 0 0 0 0 0 0 0 0 0 0 0 0 11 5 0 0 0 0 0 0 0 5
11 0 0 0 0 0 0 0 0 0 16 0 0 0 0 0 11 0 0 0 5 5 0 0 0 0 0 0 0 11 0 0 0 0 5 0 0 0 0 0 0 0 0 11 0 0 0 0 0 0 0 0 0 0 0 0 0 0 0 0 0 0 0 0 0 0 0 0 0 0 11 5 0 0 0 0 0 0 0 5
11 0 0 0 0 0 18 0 0 0 0 0 0 0 0 0 11 0 0 0 5 5 0 0 0 0 0 0 0 11 0 0 0 0 19 8 8 8 8 8 8 8 8 8 8 8 8 8 8 8 8 8 8 8 8 8 8 8 8 8 8 8 8 8 8 8 8 8 8 8 8 8 8 8 8 8 8 8 8 21
11 0 0 0 0 0 5 0 0 0 0 0 0 0 0 0 11 0 0 0 19 2 0 0 0 0 0 0 0 11 0 0 0 0 0 0 0 0 0 0 0 0 0 0 0 0 0 0 0 0 0 0 0 0 0 0 0 0 0 0 0 0 0 0 0 0 0 0 0 0 0 0 0 0 0 0 0 0 0 5
13 8 8 7 0 0 5 0 0 0 0 0 0 0 0 0 11 0 0 0 0 0 0 0 0 0 0 0 0 11 0 0 0 0 0 0 0 0 0 0 0 0 0 0 0 0 14 0 0 0 0 0 0 0 0 0 0 0 0 0 0 0 0 0 0 0 0 0 0 0 0 0 0 0 0 0 0 0 0 5
11 0 0 5 0 0 5 0 0 0 0 0 0 0 0 0 11 0 0 0 0 0 0 0 0 0 0 0 0 11 0 0 0 0 0 0 0 0 17 0 0 0 0 0 0 0 14 0 0 0 0 0 0 0 0 0 0 0 0 0 0 0 0 0 0 6 7 0 0 0 0 0 0 0 0 0 0 0 0 5
11 0 0 19 8 8 21 8 0 8 8 8 8 8 8 22 8 8 8 8 8 8 8 8 8 8 8 8 8 8 8 8 8 7 0 0 0 0 11 0 0 0 0 0 8 8 8 8 8 8 8 8 8 8 8 8 8 8 8 8 8 8 20 0 0 1 2 0 0 0 0 0 0 18 0 0 0 0 0 5
11 0 0 0 0 0 5 0 0 0 0 0 0 0 0 11 0 0 0 0 0 0 0 0 0 0 0 0 0 0 0 0 0 5 0 0 0 0 11 0 0 0 0 0 0 0 0 0 0 0 0 0 0 0 0 0 0 0 0 0 0 0 11 0 0 0 0 0 0 17 0 0 0 5 0 0 0 0 0 5
13 10 0 6 7 0 5 0 0 0 0 0 0 0 0 11 0 0 0 0 0 0 0 0 0 0 0 0 0 0 0 0 0 5 0 0 0 0 11 0 0 6 7 0 0 0 0 0 0 0 0 0 0 6 7 0 0 0 0 0 0 0 11 0 0 0 0 0 0 11 0 0 0 5 0 0 0 0 0 5
11 0 0 1 2 0 5 0 0 0 0 0 0 0 0 11 0 0 0 0 0 0 0 0 0 0 0 0 0 0 0 0 0 5 0 0 0 0 11 0 0 11 5 0 0 0 0 0 0 0 0 0 0 1 2 0 0 0 0 0 0 0 11 0 0 0 0 0 0 1 8 8 8 21 0 0 0 0 0 5
11 0 0 0 0 0 5 0 0 0 0 0 0 0 0 1 8 8 8 8 8 8 8 8 8 10 0 0 0 0 0 0 0 5 0 0 0 0 11 0 0 1 2 0 0 0 0 0 0 4 0 0 0 0 0 0 0 0 0 0 0 0 11 0 0 0 0 0 0 0 0 0 0 5 0 0 0 0 0 5
11 0 0 0 9 8 21 0 0 0 0 0 0 0 0 0 0 0 0 0 0 0 0 0 0 0 0 0 0 0 0 0 0 5 0 0 0 0 11 0 0 0 0 0 0 0 0 0 0 14 0 0 0 0 0 0 0 0 0 0 0 0 11 0 0 0 0 0 0 0 0 0 0 5 0 0 0 9 8 21
11 0 0 0 0 0 5 0 0 0 0 0 0 0 0 0 0 0 0 0 0 0 0 0 0 0 0 0 0 0 0 6 8 2 0 0 0 0 1 8 8 8 8 8 8 8 8 8 8 8 8 8 8 8 8 8 7 0 0 0 0 0 11 0 0 0 0 0 0 0 0 0 0 5 0 0 0 0 0 5
11 0 0 0 0 0 5 0 0 0 0 0 0 0 0 17 0 0 0 0 0 0 0 6 8 7 0 0 0 0 0 11 0 0 0 0 0 0 0 0 0 0 0 0 0 0 0 0 0 0 0 0 0 0 0 0 5 0 0 0 0 0 11 0 0 6 8 8 7 0 0 0 0 5 0 0 0 0 0 5
13 8 8 7 0 0 5 0 0 0 0 0 0 0 0 11 0 0 0 0 0 0 0 11 0 5 0 0 0 0 0 11 0 0 0 0 0 0 0 0 0 0 0 0 0 0 0 0 0 0 0 0 0 0 0 0 5 0 0 0 0 0 11 0 0 11 0 0 5 0 0 0 0 6 7 0 0 0 0 5
13 8 8 2 0 0 5 0 0 0 0 0 0 0 0 11 0 0 0 0 0 0 0 11 0 5 0 0 0 0 0 11 0 0 0 0 0 0 0 0 0 0 0 0 0 0 0 0 0 0 0 0 0 0 0 0 5 0 0 0 0 0 11 0 0 1 8 8 2 0 0 0 0 13 2 0 0 0 0 5
11 0 0 0 0 0 5 0 0 0 0 0 0 0 0 1 8 8 8 8 7 0 0 11 0 5 0 0 0 0 0 11 0 0 0 0 0 0 0 0 0 0 0 0 0 0 0 0 0 0 0 0 0 0 0 0 5 0 0 0 0 0 11 0 0 0 0 0 0 0 0 0 0 11 0 0 0 0 0 5
11 0 0 0 0 0 5 0 0 0 0 0 0 0 0 0 0 0 0 0 5 0 0 11 0 5 0 0 0 0 0 11 0 0 0 0 0 0 0 0 0 0 0 0 0 0 0 0 0 0 0 0 0 0 0 0 5 0 0 0 0 0 11 0 0 0 0 0 0 0 0 0 0 11 0 0 0 0 0 5
11 0 0 0 0 0 19 8 7 0 0 0 0 0 0 0 0 0 0 0 5 0 0 1 8 2 0 0 0 0 0 1 8 8 8 8 8 8 8 8 8 8 8 8 8 8 8 8 8 8 8 7 0 0 0 0 16 0 0 0 0 0 11 0 0 0 0 0 0 0 0 0 0 11 0 0 0 0 0 5
11 0 0 0 0 0 0 0 5 0 0 0 6 7 0 0 0 0 0 0 5 0 0 0 0 0 0 0 0 0 0 0 0 0 0 0 0 0 0 0 0 0 0 0 0 0 0 0 0 0 0 5 0 0 0 0 0 0 0 0 0 0 11 0 0 0 0 0 0 6 8 8 8 8 8 8 8 8 8 21
11 0 0 6 8 7 0 0 5 0 0 0 11 5 0 0 0 0 0 0 5 0 0 0 0 0 0 0 0 0 0 0 0 0 0 0 0 0 0 0 0 0 0 0 0 0 0 0 0 0 0 5 0 0 0 0 0 0 0 0 0 0 11 0 0 0 0 0 0 11 0 0 0 0 0 0 0 0 0 5
11 0 0 11 0 5 0 0 5 0 0 0 11 19 8 8 7 0 0 0 16 0 0 0 0 0 0 6 8 8 7 0 0 0 0 0 0 0 0 0 0 0 0 0 0 0 0 0 0 0 0 5 0 0 0 0 0 0 0 0 0 0 11 0 0 0 0 0 0 11 0 0 0 0 0 0 0 0 0 5
11 0 0 11 0 5 0 0 5 0 0 0 1 8 8 8 2 0 0 0 0 0 0 0 0 0 0 11 0 0 5 0 0 0 0 0 0 0 0 0 0 0 0 0 0 0 0 0 0 0 0 5 0 0 0 0 0 0 0 0 0 0 11 0 0 0 0 0 0 11 0 0 0 0 0 0 0 0 0 5
11 0 0 11 0 5 0 0 5 0 0 0 0 0 0 0 0 0 0 0 0 0 0 0 0 0 0 1 8 8 2 0 0 0 0 0 0 0 0 0 0 0 0 0 0 0 0 0 0 0 0 5 0 0 0 0 18 0 0 0 0 0 11 0 0 0 0 0 0 11 0 0 0 0 5 0 0 0 0 5
11 0 0 11 0 19 7 0 5 0 0 0 0 0 0 0 0 0 0 0 0 0 0 0 0 0 0 0 0 0 0 0 0 0 0 0 0 0 0 0 0 0 0 0 0 0 0 0 0 0 0 5 0 0 0 0 5 0 0 0 0 0 11 0 0 0 0 0 0 15 0 0 0 0 5 0 0 0 0 5
11 0 0 1 8 8 2 0 19 8 8 8 8 8 8 8 8 8 0 0 0 0 0 4 0 0 0 0 0 0 0 0 0 0 0 0 6 8 8 8 8 8 8 8 8 8 10 0 0 0 0 5 0 0 0 0 5 0 0 0 0 0 11 0 0 0 0 0 0 0 0 0 0 0 5 0 0 0 0 5
11 0 0 0 0 0 0 0 0 0 0 0 0 0 0 0 0 0 0 0 0 0 0 14 0 0 0 0 0 0 0 0 0 0 0 0 11 0 0 0 0 0 0 0 0 0 0 0 0 0 0 5 0 0 0 0 5 0 0 0 0 0 11 0 0 0 0 0 0 0 0 0 0 0 5 0 0 0 0 5
11 0 0 0 0 0 0 0 0 0 0 0 0 0 0 0 0 0 0 0 0 0 0 14 0 0 0 0 0 0 0 0 0 0 0 0 11 0 0 0 0 0 0 0 0 0 0 0 0 0 0 5 0 0 0 0 5 0 0 0 0 0 11 0 0 0 0 0 0 0 0 0 0 0 5 0 0 0 0 5
11 0 0 0 0 0 0 0 0 0 0 0 0 0 0 0 0 0 0 0 0 0 0 14 0 0 0 0 0 0 0 0 0 0 0 0 11 0 0 0 0 0 0 0 0 0 0 0 0 0 0 5 0 0 0 0 5 0 0 0 0 0 11 0 0 0 0 0 0 0 0 0 0 0 5 0 0 0 0 5
13 8 8 8 8 8 8 8 8 8 8 8 8 22 8 8 8 8 8 8 8 8 8 8 8 8 8 8 8 8 22 10 0 0 0 0 15 0 0 0 0 9 8 8 8 8 8 8 8 8 8 2 0 0 0 0 5 0 0 0 0 0 11 0 0 0 0 0 0 0 0 0 0 0 5 0 0 0 0 5
11 0 0 0 0 0 0 0 0 0 0 0 0 11 0 0 0 0 0 0 0 0 0 0 0 0 0 0 0 0 11 0 0 0 0 0 0 0 0 0 0 0 0 0 0 0 0 0 0 0 0 0 0 0 0 0 5 0 0 0 0 0 1 8 8 8 8 8 8 8 8 8 8 8 2 0 0 0 0 5
11 0 0 0 0 0 0 0 0 0 0 0 0 11 0 0 0 18 0 0 0 0 0 0 0 0 0 0 0 0 15 0 0 0 0 0 0 0 0 0 0 0 0 0 0 0 0 0 0 0 0 0 0 0 0 0 5 0 0 0 0 0 0 0 0 0 0 0 0 0 0 0 0 0 0 0 0 0 0 5
11 0 0 0 0 0 4 0 0 0 0 0 0 1 8 8 8 2 0 0 0 0 0 0 0 6 7 0 0 0 0 0 0 0 0 0 0 0 0 0 0 0 0 0 0 0 0 0 0 0 0 0 0 0 0 0 5 0 0 0 0 0 0 0 0 0 0 0 0 0 0 0 0 0 0 0 0 0 0 5
11 0 0 0 0 0 14 0 0 0 0 0 0 0 0 0 0 0 0 0 0 0 0 0 0 1 2 0 0 0 0 0 0 0 0 0 0 0 0 0 0 0 0 0 0 0 0 0 0 0 0 0 0 0 0 0 5 0 0 0 0 0 0 0 0 0 0 0 0 0 0 0 0 0 0 0 0 0 0 5
11 0 0 0 0 0 14 0 0 0 0 0 0 0 0 0 0 0 0 0 0 0 0 0 0 0 0 0 0 0 0 0 0 0 0 0 0 0 0 0 0 0 0 0 0 0 0 0 0 0 0 0 0 0 0 0 5 0 0 0 0 0 0 0 0 0 0 0 0 0 0 0 0 0 0 0 0 0 0 5
1 8 8 8 8 8 8 8 8 8 8 8 8 8 8 8 8 8 8 8 8 8 8 8 8 8 8 8 8 8 8 8 8 8 8 8 8 8 8 8 8 8 8 8 8 8 8 8 8 8 8 8 8 8 8 8 8 8 8 8 8 8 8 8 8 8 8 8 8 8 8 8 8 8 8 8 8 8 8 2